.......................................................x............................................
..............................................x......................x........x.....................
.......................x............S...............................................................
................................x.......................................................x...........
..................................................................S.................................
.............x...............................................................S......................
..............................................x.....................................................
....................................................................................................
----------------------U-----------------------------------U--------------U-----------------------U--
-------------------1--------2----------3--------3-------2----1--------------------2-----1------3----